"filename", "language", "C++", "Shell Script", "Makefile", "Markdown", "comment", "blank", "total"
"\\wsl.localhost\Ubuntu-20.04\home\dq\reactor\netserver-dq\35_\Acceptor.cpp", "C++", 28, 0, 0, 0, 2, 6, 36
"\\wsl.localhost\Ubuntu-20.04\home\dq\reactor\netserver-dq\35_\Acceptor.h", "C++", 20, 0, 0, 0, 2, 6, 28
"\\wsl.localhost\Ubuntu-20.04\home\dq\reactor\netserver-dq\35_\BankServer.cpp", "C++", 56, 0, 0, 0, 30, 22, 108
"\\wsl.localhost\Ubuntu-20.04\home\dq\reactor\netserver-dq\35_\BankServer.h", "C++", 23, 0, 0, 0, 3, 6, 32
"\\wsl.localhost\Ubuntu-20.04\home\dq\reactor\netserver-dq\35_\Buffer.cpp", "C++", 65, 0, 0, 0, 7, 14, 86
"\\wsl.localhost\Ubuntu-20.04\home\dq\reactor\netserver-dq\35_\Buffer.h", "C++", 20, 0, 0, 0, 0, 5, 25
"\\wsl.localhost\Ubuntu-20.04\home\dq\reactor\netserver-dq\35_\Channel.cpp", "C++", 96, 0, 0, 0, 2, 9, 107
"\\wsl.localhost\Ubuntu-20.04\home\dq\reactor\netserver-dq\35_\Channel.h", "C++", 42, 0, 0, 0, 6, 10, 58
"\\wsl.localhost\Ubuntu-20.04\home\dq\reactor\netserver-dq\35_\Connection.cpp", "C++", 125, 0, 0, 0, 15, 13, 153
"\\wsl.localhost\Ubuntu-20.04\home\dq\reactor\netserver-dq\35_\Connection.h", "C++", 47, 0, 0, 0, 1, 11, 59
"\\wsl.localhost\Ubuntu-20.04\home\dq\reactor\netserver-dq\35_\EchoServer.cpp", "C++", 56, 0, 0, 0, 29, 22, 107
"\\wsl.localhost\Ubuntu-20.04\home\dq\reactor\netserver-dq\35_\EchoServer.h", "C++", 23, 0, 0, 0, 3, 6, 32
"\\wsl.localhost\Ubuntu-20.04\home\dq\reactor\netserver-dq\35_\Epoll.cpp", "C++", 69, 0, 0, 0, 12, 8, 89
"\\wsl.localhost\Ubuntu-20.04\home\dq\reactor\netserver-dq\35_\Epoll.h", "C++", 24, 0, 0, 0, 15, 8, 47
"\\wsl.localhost\Ubuntu-20.04\home\dq\reactor\netserver-dq\35_\EventLoop.cpp", "C++", 121, 0, 0, 0, 14, 22, 157
"\\wsl.localhost\Ubuntu-20.04\home\dq\reactor\netserver-dq\35_\EventLoop.h", "C++", 51, 0, 0, 0, 8, 17, 76
"\\wsl.localhost\Ubuntu-20.04\home\dq\reactor\netserver-dq\35_\InetAddress.cpp", "C++", 26, 0, 0, 0, 0, 8, 34
"\\wsl.localhost\Ubuntu-20.04\home\dq\reactor\netserver-dq\35_\InetAddress.h", "C++", 18, 0, 0, 0, 2, 5, 25
"\\wsl.localhost\Ubuntu-20.04\home\dq\reactor\netserver-dq\35_\Socket.cpp", "C++", 80, 0, 0, 0, 10, 18, 108
"\\wsl.localhost\Ubuntu-20.04\home\dq\reactor\netserver-dq\35_\Socket.h", "C++", 30, 0, 0, 0, 2, 6, 38
"\\wsl.localhost\Ubuntu-20.04\home\dq\reactor\netserver-dq\35_\TcpServer.cpp", "C++", 121, 0, 0, 0, 15, 22, 158
"\\wsl.localhost\Ubuntu-20.04\home\dq\reactor\netserver-dq\35_\TcpServer.h", "C++", 47, 0, 0, 0, 1, 7, 55
"\\wsl.localhost\Ubuntu-20.04\home\dq\reactor\netserver-dq\35_\ThreadPool.cpp", "C++", 56, 0, 0, 0, 11, 15, 82
"\\wsl.localhost\Ubuntu-20.04\home\dq\reactor\netserver-dq\35_\ThreadPool.h", "C++", 30, 0, 0, 0, 4, 7, 41
"\\wsl.localhost\Ubuntu-20.04\home\dq\reactor\netserver-dq\35_\Timestamp.cpp", "C++", 30, 0, 0, 0, 18, 7, 55
"\\wsl.localhost\Ubuntu-20.04\home\dq\reactor\netserver-dq\35_\Timestamp.h", "C++", 14, 0, 0, 0, 1, 5, 20
"\\wsl.localhost\Ubuntu-20.04\home\dq\reactor\netserver-dq\35_\bank_client.cpp", "C++", 54, 0, 0, 0, 16, 19, 89
"\\wsl.localhost\Ubuntu-20.04\home\dq\reactor\netserver-dq\35_\bank_server.cpp", "C++", 26, 0, 0, 0, 6, 8, 40
"\\wsl.localhost\Ubuntu-20.04\home\dq\reactor\netserver-dq\35_\client.cpp", "C++", 55, 0, 0, 0, 15, 19, 89
"\\wsl.localhost\Ubuntu-20.04\home\dq\reactor\netserver-dq\35_\echo_server.cpp", "C++", 26, 0, 0, 0, 6, 8, 40
"\\wsl.localhost\Ubuntu-20.04\home\dq\reactor\netserver-dq\35_\makefile", "Makefile", 0, 0, 12, 0, 0, 3, 15
"\\wsl.localhost\Ubuntu-20.04\home\dq\reactor\netserver-dq\35_\readme.md", "Markdown", 0, 0, 0, 16, 0, 2, 18
"\\wsl.localhost\Ubuntu-20.04\home\dq\reactor\netserver-dq\35_\tmp1.sh", "Shell Script", 0, 10, 0, 0, 0, 1, 11
"Total", "-", 1479, 10, 12, 16, 256, 345, 2118